Je suis - 我是
J'ai - 我有
Je vais - 我要去
Je veux - 我想要
Je peux - 我能
Je dois - 我必须
Je pense - 我认为
Je crois - 我相信
Je sais - 我知道
Je comprends - 我明白
Je parle - 我说
Je mange - 我吃
Je bois - 我喝
Je dors - 我睡觉
Je travaille - 我工作
Je prends - 我拿
Je viens - 我来
Je reste - 我待
Je sors - 我出去
Je rentre - 我回家
Je fais - 我做
Je cherche - 我找
Je trouve - 我发现
Je visite - 我参观
Je conduis - 我开车
Je nage - 我游泳
Je joue - 我玩/我演奏
Je lis - 我读
Je regarde - 我看
Je finis - 我结束
Je commence - 我开始
J'écoute - 我听
Je réponds - 我回答
Je décide - 我决定
Je suis en train de... - 我正在做...
Je t'aime - 我爱你
Je te déteste - 我讨厌你
Je m'en vais - 我走了
Je m'appelle - 我叫
Je m'ennuie - 我无聊
Je m'inquiète - 我担心
Je me repose - 我休息
Je me souviens - 我记得
Je me demande - 我想知道
Je suis fatigué(e) - 我累了
Je suis d'accord - 我同意
Je suis désolé(e) - 我很抱歉
Je suis content(e) - 我很高兴
Je suis prêt(e) - 我准备好了
Je suis perdu(e) - 我迷路了
J'ai faim - 我饿了
J'ai soif - 我渴了
J'ai peur - 我害怕
J'ai froid - 我冷
J'ai chaud - 我热
J'ai raison - 我是对的
J'ai tort - 我错了
J'ai envie de... - 我想要...
J'ai besoin de... - 我需要...
J'ai hâte de... - 我期待...
J'ai mal à... - 我痛...
Il y a - 有...
C'est - 这是...
Ça va? - 你好吗？
Ça marche - 可以/行得通
Ça dépend - 看情况
Ça suffit - 够了
Ça fait - 这使得...
Ça me plaît - 我喜欢这个
Ça ne me plaît pas - 我不喜欢这个
Comment ça va? - 你怎么样？
Qu'est-ce que c'est? - 这是什么？
Qui est-ce? - 这是谁？
Où est...? - ...在哪里？
Qu'est-ce que tu fais? - 你在做什么？
Qu'est-ce qui se passe? - 发生了什么？
Qu'est-ce que tu veux? - 你想要什么？
Tu veux... ? - 你想要...吗？
Tu peux... ? - 你能...吗？
Tu dois... ? - 你必须...吗？
Tu sais...? - 你知道...吗？
Tu me crois? - 你相信我吗？
Tu viens? - 你来吗？
Où vas-tu? - 你去哪儿？
C'est combien? - 这个多少钱？
Il est quelle heure? - 现在几点了？
Comment tu t'appelles? - 你叫什么名字？
Comment ça s'écrit? - 怎么拼写？
Comment tu vas? - 你怎么样？
Ça te va? - 这样行吗？
Ça te plaît? - 你喜欢吗？
C'est possible? - 这可能吗？
C'est où? - 这在哪里？
Je ne sais pas - 我不知道
Je n'aime pas - 我不喜欢
Je ne comprends pas - 我不明白
Je n'ai pas - 我没有
Je ne peux pas - 我不能
Je ne veux pas - 我不想
Je ne sais pas quoi faire - 我不知道该怎么办
Tu m'entends? - 你听得见我吗？
Tu me comprends? - 你明白我吗？
Ça va bien? - 一切都好吗？
Ça te dérange? - 你介意吗？
C'est bon - 好的/可以了
C'est pas grave - 没关系
Pas de problème - 没问题
C'est génial - 太棒了
C'est difficile - 这很难
C'est facile - 这很容易
Je suis occupé(e) - 我很忙
Je suis en retard - 我迟到了
J'arrive - 我来了
Je reviens tout de suite - 我马上回来
Je suis ici - 我在这里
Je suis d'ici - 我来自这里
Je suis à l'heure - 我准时
Je suis content(e) de te voir - 我很高兴见到你
Tu es prêt(e)? - 你准备好了吗？
Il est temps - 该时间了
Il fait beau - 天气很好
Il fait chaud - 天气很热
Il fait froid - 天气很冷
Il pleut - 下雨了
Il neige - 下雪了
Il fait du vent - 有风
Qu'est-ce qui ne va pas? - 怎么了？
Qu'est-ce que tu dis? - 你说什么？
Je t'en prie - 不客气
Je n'ai aucune idée - 我完全不知道
Ça ne fait rien - 没关系
Ça me va - 我没问题
Ça ne va pas - 不行
C'est tout - 就这样
C'est incroyable - 这太不可思议了
C'est impossible - 这是不可能的
Je ne crois pas - 我不信
Je te le promets - 我向你保证
Tu te souviens? - 你还记得吗？
Tu plaisantes? - 你在开玩笑吗？
Laisse-moi tranquille - 让我安静一下
Qu'est-ce que tu en penses? - 你觉得怎么样？
Je suis d'accord avec toi - 我同意你的看法
Je n'en peux plus - 我受不了了
Je m'en fiche - 我不在乎
Ça m'est égal - 我无所谓
C'est nul - 这很糟糕
C'est trop - 太多了
C'est pas mal - 不错
Je me lève - 我起床
Je m'habille - 我穿衣服
Je prends une douche - 我洗澡
Je me brosse les dents - 我刷牙
Je me couche - 我睡觉
J'allume la lumière - 我开灯
J'éteins la lumière - 我关灯
Je prends le métro - 我坐地铁
Je descends - 我下车
Je monte - 我上车
J'attends quelqu'un - 我在等人
Je téléphone à quelqu'un - 我给某人打电话
Je t'appelle plus tard - 我稍后给你打电话
Je fais les courses - 我在购物
Je fais du shopping - 我去逛街
Je rentre chez moi - 我回家
Tu vas bien? - 你好吗？
Ça se passe bien? - 事情进展得顺利吗？
C'est gentil - 真好
C'est fou! - 太疯狂了！
Ça me rend fou/folle - 这让我疯了
Je suis en colère - 我生气了
Je suis heureux/heureuse - 我很高兴
Je suis triste - 我很难过
Je suis fatigué(e) - 我累了
Je suis en forme - 我状态很好
Ça va mieux - 好多了
Tu as raison - 你是对的
Tu as tort - 你错了
Je te crois - 我相信你
C'est à toi - 轮到你了
C'est à moi - 轮到我了
C'est cher - 这很贵
C'est pas cher - 这不贵
C'est gratuit - 这是免费的
Tu as fini? - 你结束了吗？
Je te comprends - 我理解你
Je t'attends - 我在等你
Je t'écoute - 我在听你
J'ai oublié - 我忘了
J'ai compris - 我明白了
Je suis en train de réfléchir - 我正在思考
Je suis désolé(e), je ne peux pas - 对不起，我不能
Il n'y a pas de souci - 没问题
Je suis pressé(e) - 我很急
C'est trop tard - 太晚了
C'est bientôt fini - 快结束了
Je n'y crois pas - 我不相信
Ça ne va pas du tout - 一点都不好
Je t'accompagne - 我陪你
Je suis sûr(e) - 我确定